1111111
10010C1
100E001
1P01001
1111111
