1111111
111E111
1001001
1P000C1
1111111
