11111
11E11
11011
1P0C1
11111
