NO    imgs/north.xpm
SO    imgs/south.xpm
WE    imgs/west.xpm
EA    imgs/east.xpm
F    0, 0, 0

C 200,255,255

11111 111
10001 101
10101 111
10N01
10001
11111
     
11111
10001
10001
10001
11111